1
11
101
1001
10001
100001
1000001
1000C001
100000001
1001000000
10000110110
1P0011E00000
1111111111111
