1111111111111111111111111
1E00000000S0000C00000C001
1010010100100000101001001
1010010000101010001001001
1P00000S0C00C0000000000S1
1111111111111111111111111
