1111111111111
10S10000000C1
1000S11111001
1P0011E000001
1111111111111
